11111
10001
10E01
11C01
1CP01
10001
11111