111111111111111111111111
100000100010110001010001
10E000000000000000000001
11C011110111000101010001
1CP011000C00011101010001
100000001100000001C10C01
111111111111111111111111
