111111111111111111111111111111111111111111111111111111111111111111111111111111
100000100010110000000000000000000000000000000000000000000000000000000000000001
10E000000000000000000000000000000000000000000000000000000000000000000000000001
11C011110111000100000000000000000000000000000000000000000000000000000000000001
1CP011000C00011100000000000000000000000000000000000000000000000000000000000001
100000001100000000000000000000000000000000000000000000000000000000000000000001
110111111111111100000000000000000000000000000000000000000000000000000000000001
110111111111111100000000000000000000000000000000000000000000000000000000000001
100000100010110000000000000000000000000000000000000000000000000000000000000001
100000000000000000000000000000000000000000000000000000000000000000000000000001
110011110111000100000000000000000000000000000000000000000000000000000000000001
1C0011000C00011100000000000000000000000000000000000000000000000000000000000001
100000001100000000000000000000000000000000000000000000000000000000000000000001
111111111111101100000000000000000000000000000000000000000000000000000000000001
111111111111101100000000000000000000000000000000000000000000000000000000000001
100000100010101000000000000000000000000000000000000000000000000000000000000001
100000000000000000000000000000000000000000000000000000000000000000000000000001
11C011110111000100000000000000000000000000000000000000000000000000000000000001
1C0011000C00011100000000000000000000000000000000000000000000000000000000000001
100000001100000000000000000000000000000000000000000000000000000000000000000001
100000100010101000000000000000000000000000000000000000000000000000000000000001
100000000000000000000000000000000000000000000000000000000000000000000000000001
11C011110111000100000000000000000000000000000000000000000000000000000000000001
1C0011000C00011100000000000000000000000000000000000000000000000000000000000001
100000001100000000000000000000000000000000000000000000000000000000000000000001
100000100010101000000000000000000000000000000000000000000000000000000000000001
100000000000000000000000000000000000000000000000000000000000000000000000000001
11C011110111000100000000000000000000000000000000000000000000000000000000000001
1C0011000C00011100000000000000000000000000000000000000000000000000000000000001
100000001100000000000000000000000000000000000000000000000000000000000000000001
100000100010101000000000000000000000000000000000000000000000000000000000000001
100000000000000000000000000000000000000000000000000000000000000000000000000001
11C011110111000100000000000000000000000000000000000000000000000000000000000001
1C0011000C00011100000000000000000000000000000000000000000000000000000000000001
100000001100000000000000000000000000000000000000000000000000000000000000000001
100000100010101000000000000000000000000000000000000000000000000000000000000001
100000000000000000000000000000000000000000000000000000000000000000000000000001
11C011110111000100000000000000000000000000000000000000000000000000000000000001
1C0011000C00011100000000000000000000000000000000000000000000000000000000000001
100000001100000000000000000000000000000000000000000000000000000000000000000001
111111111111111111111111111111111111111111111111111111111111111111111111111111