111111111111111111111111
100000100010110011010001
10E000000000000010000001
11C011110111000111010001
1CP011000C00011111010001
100000001100000011C10C01
111111111111111111111111